@******@@@*****
@****@@@@@@@***
@*************1
*@@@@@@@*******
********@@@@@@@
1***@**********
****@****@*****
****@****@*****
****@****@*****
****@****@*****
*********@****X